#####.....#####
#...#.....#...#
#.(.#..?).#.(.#
#...#.....#...#
#####.....#####
...............
........)......
.......<.......
...............
.............%.
#####.....#####
#...#.....#...#
#.(.#.....#.(.#
#...#.....#...#
#####.....#####
